P   #       #      #
##  #       #   #   
### #    ## #   #   
#   #   T # #   #   
#      #  # #   #   
#  ####   # # ##### 
 #        #    ###  
  #       #     #   
   #      #         
    #     #         
     #    #         
      #             
       #            
        #      # #  
         #     # # #
          #    #E# #
           #   ### #
            #      #
             #     #
####################