     ##########     
   ##          ##   
  #              #  
  #              #  
 #                # 
 #   ###    ###   # 
#    ###    ###    #
#    ###    ###    #
#        #P        #
#        ##        #
#  ##          ##  #
#  ###        ###  #
#   ###      ###   #
#    ###    ###    #
 #    ########    # 
 #     ######     # 
  #              #  
  #              #  
   ##     E    ##   
     ##########     