       ###          
     # ###  ##      
    #   ###   ## #  
   ##    ###     # E
  ### ##     #   ###
#   #       ##      
##  #   ###     ##  
   #         ##    #
  #  #########    ##
#   #          # ###
####   ######### ###
#    # ##          #
#  ###     ####    #
##   ### ###    #  #
###        #  ######
########## ##   #  #
           ###  #  #
           ####    #
    ###  #     ##  #
P       ######    ##
