#########  #########
#########  #########
#########  #########
#########  #########
#########  #########
#########  #########
#########  #########
#########  #########
#########  #########
#########  #########
                    
                    
                    
                    
                    
                    
             G   # E
         ###########
        ############
P      #############
