#########  #########
#########  #########
#########  #########
#########  #########
#########  #########
#########  #########
#########  #########
#########  #########
#########  #########
#########  #########
                    
                    
                    
                    
                    
                    
                 # E
         ###########
        ############
P      #############