##      ############
 #   ##             
 #  ####     #      
 ##   # T     # #   
 ###  #  #     ##   
 #   ##   T   ###   
 #  ###    #        
 ##   #     T       
 ###  #      #      
 #   ##       T     
 #  ###        #   E
 ##   #         ####
 ###  #         #   
 #   ##         #   
 #  ###         #   
 ##   #         #   
####            #   
P    #          #   
####################
#                  #